32 32 32 32 32 32 32 32 32 32 32 32 32 32 32 32 32 32 32 32 32 32 32 32 32 32 32 32 32 32 32 32 32 32 32 32 32 32 32 32 32 32 32 32 32 32 32 32 32 32 
32 18 1 1 1 1 1 1 1 1 1 1 1 1 1 1 1 1 1 1 1 1 1 1 1 1 1 1 1 1 1 1 1 1 1 1 1 1 1 1 18 1 1 18 1 1 1 1 18 32 
32 18 18 1 1 1 1 1 1 1 1 1 1 1 1 1 1 1 1 1 1 1 1 1 1 1 1 1 1 1 1 1 1 1 1 1 1 1 1 1 18 18 1 18 1 1 1 1 18 32 
32 1 18 1 1 18 18 18 18 1 1 18 18 1 1 18 18 1 1 1 1 18 18 1 18 1 1 1 1 1 1 1 1 1 1 1 18 18 18 1 1 18 1 18 1 1 18 18 18 32 
32 1 18 1 1 1 1 18 1 1 1 18 18 1 1 1 1 18 1 1 1 1 1 1 1 1 1 1 1 1 1 1 1 1 1 1 1 1 1 1 1 18 18 1 1 1 18 1 18 32 
32 1 1 1 1 1 1 1 1 1 1 1 1 1 1 18 18 1 1 1 18 1 1 1 1 18 1 1 18 1 1 1 1 1 1 1 1 1 1 1 1 1 18 1 1 1 18 18 1 32 
32 1 1 1 18 18 18 18 1 1 1 1 1 1 1 18 1 1 1 1 1 18 18 18 1 1 18 18 18 1 1 1 1 1 1 18 18 1 1 1 1 1 18 1 1 18 18 18 1 32 
32 1 1 18 1 1 1 1 1 1 1 18 1 1 18 1 1 18 1 1 1 1 1 1 1 1 1 1 1 1 1 1 1 1 1 18 18 18 18 1 18 18 1 1 1 18 18 1 1 32 
32 1 1 18 1 1 1 1 1 1 1 1 1 18 1 1 1 1 1 1 1 1 1 1 1 1 1 1 1 1 1 18 1 1 1 1 18 18 18 1 1 1 1 1 1 18 1 18 1 32 
32 1 1 18 1 18 1 1 1 1 1 1 1 1 1 1 1 1 1 1 1 1 1 1 1 1 1 1 1 1 1 1 1 1 18 1 18 18 18 1 1 1 1 1 1 1 1 18 1 32 
32 1 1 1 1 18 1 1 18 1 18 1 18 1 1 1 1 1 1 1 1 1 18 18 1 1 1 1 1 1 18 1 1 1 1 1 1 1 1 1 18 1 18 1 1 1 18 1 1 32 
32 1 1 1 1 1 1 1 1 18 1 1 1 18 1 18 18 1 1 1 1 1 1 1 1 1 1 1 1 1 1 1 1 1 1 1 1 1 1 1 18 18 1 1 1 1 1 1 1 32 
32 1 18 18 1 1 1 1 1 1 1 1 1 18 1 1 1 1 1 1 18 18 1 18 1 1 1 18 1 1 1 1 1 1 1 1 1 1 1 1 1 1 1 1 1 18 18 1 1 32 
32 1 1 1 1 1 1 1 1 1 1 1 1 18 1 1 1 18 1 18 1 1 18 1 1 1 18 1 1 1 1 1 1 1 1 1 1 1 1 1 1 18 1 1 1 18 18 1 1 32 
32 1 1 1 1 1 1 1 1 1 1 1 1 18 1 1 1 1 1 1 1 1 1 1 1 1 1 1 1 1 1 1 1 1 1 1 1 18 1 1 1 1 1 1 1 18 1 18 1 32 
32 1 1 1 1 1 1 1 1 1 18 1 18 18 1 1 1 1 1 1 1 1 1 1 1 1 1 1 1 1 1 1 1 1 1 1 1 1 1 1 18 18 1 1 1 18 18 18 18 32 
32 1 1 1 1 1 1 1 1 18 1 18 18 1 1 1 1 1 1 1 1 1 1 1 1 1 1 1 1 1 1 1 1 1 1 1 1 1 1 1 1 1 1 1 18 1 1 1 1 32 
32 1 18 1 18 1 1 1 1 1 18 1 1 1 1 1 1 1 1 1 1 1 1 1 1 1 1 1 1 1 1 1 1 1 1 1 1 1 1 1 18 18 1 1 1 1 1 1 1 32 
32 1 1 1 18 1 1 1 1 1 1 1 1 18 1 1 1 18 1 1 1 1 1 1 1 1 1 1 1 1 1 1 1 1 1 1 1 18 18 1 1 1 1 1 1 1 1 1 1 32 
32 1 1 1 1 1 1 1 1 1 1 18 1 1 1 1 1 1 1 1 1 1 1 1 18 1 18 1 1 1 1 1 1 1 1 1 18 1 1 1 1 18 1 1 1 18 1 1 18 32 
32 1 18 18 18 18 1 1 1 1 1 18 1 18 18 18 18 1 1 18 18 18 1 1 1 1 1 1 1 1 1 1 1 1 1 1 1 1 1 1 1 1 1 1 18 1 18 1 1 32 
32 1 1 1 1 18 1 18 1 1 1 1 1 1 1 1 1 1 1 1 1 1 1 1 18 1 1 1 1 1 1 1 1 1 18 1 1 1 1 1 1 1 1 1 18 18 18 18 18 32 
32 1 1 1 1 1 1 1 1 18 1 1 18 1 1 1 1 1 1 1 1 1 1 1 1 1 1 1 1 1 1 1 1 1 1 1 1 1 1 1 1 1 1 1 1 1 1 1 18 32 
32 1 1 1 1 1 1 1 1 1 1 1 1 1 1 1 1 1 1 1 1 1 1 1 1 1 1 1 1 1 1 1 1 1 1 1 1 1 1 1 1 1 1 1 18 18 18 18 1 32 
32 1 1 1 1 1 1 1 1 1 1 1 1 1 1 1 1 1 1 1 1 1 1 1 1 18 18 1 1 1 18 1 1 18 1 1 1 1 1 18 1 1 18 18 1 1 1 1 1 32 
32 1 1 18 18 1 18 1 1 1 1 18 1 1 1 1 1 1 1 1 1 1 1 1 18 18 1 1 1 1 1 1 1 1 1 1 1 1 1 1 1 1 1 1 1 1 1 1 1 32 
18 18 1 1 18 1 18 18 18 1 1 1 1 1 1 1 1 18 1 1 1 1 1 1 1 1 1 1 1 1 1 1 18 1 1 1 1 1 1 1 1 1 1 1 1 1 1 1 1 32 
18 18 1 1 1 1 18 1 1 18 1 18 1 18 1 1 1 18 1 1 18 1 1 1 1 1 1 1 1 1 18 1 1 1 1 1 1 1 1 1 1 18 1 1 18 1 1 1 1 32 
32 1 18 18 18 18 1 1 1 18 1 1 18 1 1 1 1 1 1 1 1 1 1 1 18 18 1 18 1 1 18 1 1 1 1 1 18 18 1 18 18 1 18 1 18 1 18 18 1 32 
32 1 1 1 1 1 1 1 1 1 1 1 1 1 1 1 1 1 1 1 1 1 18 1 1 1 18 18 1 1 1 1 18 18 1 1 1 1 1 1 1 1 1 1 1 1 1 1 18 32 
32 1 18 1 1 1 1 1 1 1 1 1 1 1 1 1 1 1 1 1 1 18 1 1 1 1 1 1 1 1 1 1 1 1 1 1 1 1 1 1 1 1 18 18 1 1 1 18 1 32 
32 1 1 1 1 1 1 1 18 1 1 1 1 1 1 1 1 1 1 1 1 1 1 1 1 1 1 1 1 1 1 1 1 1 1 18 1 18 1 1 1 1 1 1 1 1 18 18 1 32 
32 1 1 1 1 1 1 1 1 1 1 1 1 1 1 1 1 1 1 1 1 1 1 1 1 1 1 1 1 1 1 1 1 1 1 1 1 1 1 1 1 1 1 1 1 1 1 18 1 32 
32 1 18 1 1 18 1 1 1 1 1 1 1 1 1 1 18 1 1 1 1 1 1 1 1 1 1 1 1 1 1 1 1 1 1 1 1 1 1 1 1 1 1 1 18 18 1 1 1 32 
32 1 1 1 1 1 1 1 1 1 1 1 1 18 1 18 1 1 1 1 1 1 1 1 1 1 1 1 1 1 1 1 1 1 1 1 1 1 1 1 1 1 1 18 18 1 1 1 1 32 
32 1 1 18 1 1 1 1 1 1 1 1 1 1 1 1 1 1 1 18 1 1 1 1 1 1 1 1 1 1 1 1 1 1 1 1 1 1 1 1 1 1 18 18 18 1 1 1 1 32 
32 1 18 18 1 18 1 1 1 1 18 1 1 1 1 18 18 1 18 1 1 1 1 1 1 1 18 18 1 1 1 1 1 1 1 1 1 1 1 1 1 18 18 1 1 1 1 1 1 32 
32 1 1 18 1 1 1 1 1 1 1 1 1 18 18 1 1 1 18 1 1 18 1 1 18 18 1 1 1 1 1 1 1 1 1 1 18 18 18 1 1 18 1 18 1 1 1 1 1 32 
32 1 1 1 1 1 1 1 18 18 18 1 1 1 1 1 18 1 18 1 18 1 1 1 1 1 1 1 1 1 1 1 1 1 1 1 1 1 1 1 1 1 18 18 1 1 1 1 1 32 
32 1 1 1 1 1 18 18 1 1 1 1 1 1 1 18 18 18 1 1 1 1 1 1 1 1 1 1 1 1 1 1 18 18 1 18 1 1 1 1 1 1 18 18 18 1 1 1 1 32 
32 1 1 1 1 18 18 1 1 1 1 18 18 18 18 1 1 1 1 1 1 1 1 1 1 1 1 1 1 1 1 1 1 1 1 1 18 1 1 1 1 1 1 1 18 18 1 1 1 32 
32 1 1 1 1 18 1 1 18 18 18 1 1 1 1 1 1 1 1 1 1 1 1 1 1 1 1 1 18 1 1 1 1 1 1 1 1 1 1 1 1 18 1 1 1 1 1 1 1 32 
32 1 1 1 1 18 18 18 18 1 1 1 1 1 1 1 1 1 1 1 1 1 1 1 1 1 1 1 1 1 1 1 18 1 1 1 1 18 1 1 1 18 18 18 18 18 1 1 1 32 
32 1 18 18 1 18 18 18 1 1 1 1 1 1 1 1 1 1 1 1 1 1 18 1 1 1 1 1 1 18 1 1 1 1 1 18 1 1 1 1 1 1 1 18 1 1 1 1 1 32 
32 1 18 1 1 1 1 18 18 18 18 18 1 18 18 18 18 18 1 18 1 18 1 18 18 18 1 1 1 1 1 1 18 1 1 1 1 1 1 1 1 1 18 18 1 1 1 1 1 32 
32 1 1 1 1 1 1 18 1 1 1 1 1 1 1 1 1 1 1 1 1 1 18 18 1 18 1 1 1 18 18 18 1 1 18 18 1 1 1 1 1 1 1 1 1 1 1 1 1 32 
32 1 1 1 1 1 1 1 1 1 1 1 18 18 18 18 18 1 1 1 18 1 1 1 1 1 1 1 1 1 1 1 1 1 1 1 1 18 18 18 1 18 1 1 18 1 1 1 1 32 
32 1 18 1 18 1 1 18 1 1 1 1 18 18 18 1 1 18 1 1 1 18 1 1 1 1 1 1 1 1 1 1 1 1 1 1 1 1 1 1 1 1 1 1 1 1 1 1 1 32 
32 1 1 1 1 1 1 1 1 1 1 1 1 1 1 1 1 1 1 1 1 1 1 1 1 1 1 1 1 1 1 1 1 1 1 1 1 1 1 1 1 1 1 1 1 1 1 1 1 32 
32 32 32 32 32 32 32 32 32 32 32 32 32 32 32 32 32 32 32 32 32 32 32 32 32 32 32 32 32 32 32 32 32 32 32 32 32 32 32 32 32 32 32 32 32 32 32 32 32 32 
